8
24
AAAASAAAAAAAAAAAAAAAAAGT
AAAASSAAAAAAAAAASAAAAGTT
AAAAAAAAASAAAAAAAAAAATTT
AAAAAASAAAAAAAASAAAAGTTC
AAAAAAAAAASAAAAAAAAGTTTC
GAAAAAAAAAWAAAAAAGGTTTCC
TGGGGGAAAAAAAAGGGTTTCCCC
TTTTTTGGGGGGGGTTTTCCCCCC
