8
24
AAAACAAAAAAAAAAAAAAAAAGT
AAAACSAAAAAAAAAASAAPAGTT
AAAACAAAASAAAAAAAAAAATTT
AAAACASAAAAAAAASAAAAGTTC
AAAAAAAAAASAAAAAAAAGTTTC
GAAAAAAAAAWAAAAAAGGTTTCC
TGGGGGAAAAAAAAGGGTTTCCCC
TTTTTTGGGGGGGGTTTTCCCCCC
